Year,fatal_injuries,minor_injuries,serious_injuries,no_injuries,all_incidents,total_injuries
2000,1,0,0,3,4,0
2001,2,0,2,5,9,2
2002,2,1,2,7,12,3
2003,3,1,4,6,14,5
2004,2,2,5,9,18,7
2005,1,1,1,3,6,2
2006,1,2,1,7,11,3
2007,1,1,3,12,17,4
2008,0,3,1,8,12,4
2009,3,0,0,4,7,0
2010,4,2,5,7,18,7
2011,1,0,1,5,7,1
2012,3,0,0,2,5,0
2013,1,0,3,2,6,3
2014,5,0,1,4,10,1
2015,1,1,3,7,12,4
2016,2,0,4,4,10,4
2017,3,0,1,4,8,1
2018,3,0,0,1,4,0
2019,3,0,1,2,6,1
2020,1,0,0,1,2,0
